........................................
.......RRRRRRRRRRRRRRRRRRRRRRRRRRRRRRRRR
.......R................................
.......R................................
.......R................................
.......R................................
.......R................................
SRRRRRRR................................
........................................