........................................
........................................
.........RRRRRRRRRRRRRRRRRRRRRRRRRRRRRRS
.........R..............................
.........R..............................
.........R..............................
.........R..............................
.........RRRRRRRRRRRRRRRRRRRRRRRRRRRRRRR
........................................