........................................
........................................
........RRRRRRRRRRRRRRRRRRRRRRRRRRRRRRRS
........R...............................
........R...............................
........R...............................
........R...............................
........RRRRRRRRRRRRRRRRRRRRRRRRRRRRRRRR
........................................