........................................
........................................
...........RRRRRRRRRRRRRRRRRRRRRRRRRRRRR
...........R............................
...........R............................
...........R............................
...........R............................
...........R............................
...........R............................
...........R............................
SRRRRRRRRRRR............................
........................................