........................................
........................................
........................................
........................................
.............RRRRRRRRRRRRRRRRRRRRRRRRRRS
.............R..........................
.............R..........................
.............R..........................
.............R..........................
.............R..........................
.............RRRRRRRRRRRRRRRRRRRRRRRRRRR
........................................